%%%%%%%
%P   .%
% .%. %
%. % .%
%%%%%%%